44444444444444444444
44444444444444444444
44444444444444444444
44444444444444444444
44444444444444444444
44434444344434444444
40111111111112444444
44434444344434444444
44444444444444444444
44444444444444444444
44444444444444444444
