44444444444444444444
44444444444444444444
44444444444444444444
44444434444444444444
44444447111244444444
44444435344444444434
44444446111111111944
44444434444444443544
44444444444444401844
44444444444444444444
44444444444444444444
