44444444444444444444
44444444444444444444
44444444444444444444
44444444444444444444
44444444444444444444
44019447119444711244
44445335445434534444
44445445335434544444
44446118446111844444
44444444444444444444
44444444444444444444
