44444444444444444444
44444443444444444444
44444447111244444444
44444435344444444444
44444445444444444444
44444445444444444444
44444445444444444444
44444435444444444444
44401118444444444444
44444444344444444444
44444444444444444444
