44444444444444444444
44444444444444444444
44401111111944444444
44443444443544444444
44443444443544444444
44447111111844444444
44445344444444444444
44445344344444444444
44446111111124444444
44444444444444444444
44444444444444444444
