44444444444444444444
44444444444444444444
44444444444444444444
44444444444444444444
44444444444444444444
44019444444444711244
44435444444444544444
44435444444333544444
44436111111111844444
44433444444444444444
44444444444444444444
